##########
#........#
#.##...###
#........#
###...#..#
#.....#..#
#.#####..#
#........#
#........#
##########